111111111111111111111111111111111
100000000000000000000000000000001
10000000000100000000P000000000001
10000000001CE00000000000000000001
100000000001000000000000000000001
100000000000000000000000000000001
111111111111111111111111111111111
