111111111111111111111111111111111
100000000000000000000000000000001
10000000000100000000C000000000001
10000000001C10E000000000000000001
10000000000100000000P000000000001
100000000000000000000000000000001
111111111111111111111111111111111
