1111111111111111111111111111111111
1E0000000000000C00000C0000000E0001
1010010100100000101001000000010101
1010010010101010001001000P00010101
100000000C00C000000000W000000000C1
1111111111111111111111111111111111
