111111111111111111111111111111111111111111111111111
10000000000000E0000000000000000000000000000100C0001
100000000000000000000000000000000000000000010000001
1000000C0000000000000000000000000000000000010000001
1000000C0000000000000000000000000000000C00010000001
1000000C0000000000000000C00000000000000000000000001
100000000000000000000001111111111111100000000000001
1000000C00000000000000000000000000001000C0000000001
1000000C0000000000000000000000000000000000000000001
1000000C0000000011111111000000000000000000000000001
1000000C0000000000000000000000000000000000000000001
1000000C0000000000000000000000000000000000000000001
100111111111100000000000000000000000000000000000001
1P0000000000000000000000000000000000000000000000001
111111111111111111111111111111111111111111111111111
